1,1,2,2,3,3,4,4,5,5
1,S,0,0,0,0,2,0,1,1
2,0,3,3,3,0,2,0,2,2
2,0,1,0,4,0,0,0,3,3
3,1,1,0,4,2,2,0,4,4
3,0,0,0,4,0,0,0,5,5
4,0,5,5,5,0,3,3,4,4
4,0,0,0,0,0,0,G,3,3
5,1,2,3,4,5,2,3,2,2
5,5,4,4,3,3,2,2,1,1

